*********
*       *
*       *
*   *   *
* * @  **
*********